i,X1,Y1,Z1,M1,X2,Y2,Z2,M2,XDIFF,YDIFF,ZDIFF,MDIFF,420,116,8
0,-1440,1187,-2741,3316.0,-951,1371,-2961,3398.8,489,184,-220,82.8,,,
1,-1422,1170,-2746,3306.3,-962,1376,-2956,3399.5,460,206,-210,93.2,,,
2,-1435,1190,-2741,3314.9,-965,1376,-2956,3400.4,470,186,-215,85.5,,,
3,-1435,1182,-2743,3313.7,-962,1376,-2958,3401.3,473,194,-215,87.6,,,
4,-1445,1180,-2751,3323.9,-967,1373,-2950,3394.5,478,193,-199,70.6,,,
5,-1430,1182,-2740,3309.0,-956,1373,-2958,3398.4,474,191,-218,89.3,,,
6,-1430,1195,-2737,3311.2,-943,1373,-2961,3397.3,487,178,-224,86.1,,,
7,-1435,1180,-2751,3319.6,-956,1368,-2956,3394.6,479,188,-205,75.0,,,
8,-1432,1192,-2732,3306.9,-965,1361,-2953,3391.7,467,169,-221,84.9,,,
9,-1430,1187,-2746,3315.8,-946,1376,-2963,3401.1,484,189,-217,85.3,,,
10,-1437,1187,-2730,3305.6,-956,1383,-2953,3398.1,481,196,-223,92.5,,,
11,-1425,1195,-2740,3311.5,-965,1376,-2956,3400.4,460,181,-216,88.8,,,
12,-1425,1197,-2732,3305.6,-953,1373,-2961,3400.1,472,176,-229,94.5,,,
13,-1427,1180,-2746,3312.0,-967,1363,-2958,3397.4,460,183,-212,85.5,,,
14,-1427,1185,-2737,3306.3,-965,1366,-2956,3396.3,462,181,-219,90.0,,,
15,-1427,1175,-2748,3311.9,-956,1368,-2947,3386.8,471,193,-199,74.9,,,
16,-1440,1197,-2737,3316.3,-951,1381,-2963,3404.5,489,184,-226,88.3,,,
17,-1425,1195,-2741,3312.4,-956,1366,-2953,3391.2,469,171,-212,78.8,,,
18,-1437,1187,-2746,3318.8,-956,1373,-2971,3409.7,481,186,-225,90.9,,,
19,-1427,1202,-2746,3319.9,-957,1371,-2958,3397.8,470,169,-212,77.9,,,
20,-1435,1187,-2741,3313.8,-965,1376,-2961,3404.7,470,189,-220,90.9,,,
21,-1437,1185,-2751,3322.2,-956,1356,-2976,3407.2,481,171,-225,85.0,,,
22,-1425,1187,-2890,3433.9,-903,1363,-3105,3509.2,522,176,-215,75.3,,,
23,-1407,1192,-3048,3562.4,-863,1333,-3263,3628.9,544,141,-215,66.5,,,
24,-1450,1172,-3097,3614.9,-888,1313,-3307,3667.3,562,141,-210,52.4,,,
25,-1475,1165,-3100,3625.3,-928,1296,-3302,3666.6,547,131,-202,41.3,,,
26,-1467,1157,-3105,3623.8,-911,1286,-3310,3666.0,556,129,-205,42.3,,,
27,-1527,1127,-3102,3636.5,-960,1257,-3317,3674.8,567,130,-215,38.3,,,
28,-1462,1058,-3085,3574.1,-896,1190,-3302,3622.4,566,132,-217,48.4,,,
29,-1292,966,-3127,3518.6,-688,1103,-3312,3558.0,604,137,-185,39.4,,,
30,-1232,966,-3135,3504.2,-646,1088,-3300,3534.3,586,122,-165,30.1,,,
31,-1172,1041,-3142,3511.3,-575,1137,-3283,3521.6,597,96,-141,10.2,,,
32,-1172,1068,-3145,3522.1,-562,1177,-3307,3554.9,610,109,-162,32.8,,,
33,-1247,778,-2877,3230.7,-693,882,-2930,3137.4,554,104,-53,-93.3,,,
34,-1210,318,-2581,2868.2,-668,401,-2567,2682.6,542,83,14,-185.6,,,
35,-1115,-46,-2247,2508.9,-625,51,-2202,2289.5,490,97,45,-219.3,,,
36,-1080,-205,-2102,2372.1,-615,-136,-2053,2147.4,465,69,49,-224.6,,,
37,-1032,1,-1998,2248.8,-575,111,-1981,2065.7,457,110,17,-183.0,,,
38,-1000,101,-1916,2163.6,-575,215,-1885,1982.4,425,114,31,-181.2,,,
39,-900,158,-1895,2103.8,-450,247,-1890,1958.5,450,89,5,-145.3,,,
40,-540,260,-1906,1998.0,-93,331,-1875,1906.3,447,71,31,-91.7,,,
41,-522,190,-1897,1976.7,-73,260,-1875,1894.3,449,70,22,-82.3,,,
42,-735,6,-1862,2001.8,-291,103,-1840,1865.7,444,97,22,-136.1,,,
43,-897,-33,-1822,2031.1,-435,38,-1808,1860.0,462,71,14,-171.1,,,
44,-1102,-33,-1711,2035.4,-683,48,-1692,1825.3,419,81,19,-210.2,,,
45,-1245,33,-1640,2059.3,-818,138,-1623,1822.7,427,105,17,-236.6,,,
46,-1375,272,-1513,2062.5,-975,371,-1517,1841.1,400,99,-4,-221.4,,,
47,-1447,480,-1420,2083.4,-1057,605,-1407,1860.9,390,125,13,-222.5,,,
48,-1445,436,-1405,2062.1,-1055,552,-1392,1831.8,390,116,13,-230.3,,,
49,-1422,205,-1498,2075.6,-1020,317,-1503,1843.9,402,112,-5,-231.7,,,
50,-1395,108,-1543,2082.9,-990,185,-1537,1837.6,405,77,6,-245.3,,,
51,-1400,63,-1551,2090.4,-1002,160,-1546,1849.2,398,97,5,-241.1,,,
52,-1430,48,-1541,2102.8,-1000,158,-1530,1834.6,430,110,11,-268.2,,,
53,-1432,26,-1553,2112.6,-1010,136,-1535,1842.5,422,110,18,-270.1,,,
54,-1425,8,-1548,2104.0,-1002,123,-1543,1843.9,423,115,5,-260.1,,,
55,-1432,26,-1551,2111.1,-997,126,-1532,1832.2,435,100,19,-279.0,,,
56,-1417,11,-1543,2095.0,-1005,131,-1527,1832.7,412,120,16,-262.2,,,
57,-1417,26,-1543,2095.1,-997,131,-1535,1835.0,420,105,8,-260.0,,,
58,-1422,36,-1543,2098.6,-987,138,-1525,1821.8,435,102,18,-276.9,,,
59,-1407,26,-1538,2084.7,-995,146,-1537,1836.8,412,120,1,-247.9,,,
60,-1407,26,-1556,2098.0,-980,151,-1541,1832.5,427,125,15,-265.5,,,
61,-1427,46,-1558,2113.2,-992,131,-1527,1825.6,435,85,31,-287.6,,,
62,-1402,31,-1528,2074.0,-995,133,-1525,1825.7,407,102,3,-248.2,,,
63,-1387,31,-1541,2073.5,-990,143,-1535,1832.2,397,112,6,-241.4,,,
64,-1427,11,-1541,2100.3,-987,121,-1527,1822.2,440,110,14,-278.0,,,
65,-1407,0,-1553,2095.6,-990,98,-1535,1829.2,417,98,18,-266.4,,,
66,-1410,-38,-1548,2094.2,-987,66,-1535,1826.1,423,104,13,-268.1,,,
67,-1412,-51,-1551,2098.1,-992,56,-1537,1830.2,420,107,14,-267.9,,,
68,-1415,-51,-1561,2107.5,-970,51,-1537,1818.2,445,102,24,-289.3,,,
69,-1432,-56,-1568,2124.2,-980,41,-1537,1823.3,452,97,31,-300.9,,,
70,-1402,-81,-1536,2081.2,-997,28,-1535,1830.6,405,109,1,-250.6,,,
71,-1400,-71,-1551,2090.6,-990,31,-1537,1828.5,410,102,14,-262.1,,,
72,-1417,-81,-1541,2095.0,-987,21,-1537,1826.7,430,102,4,-268.3,,,
73,-1442,-63,-1516,2093.2,-1035,18,-1510,1830.8,407,81,6,-262.5,,,
74,-1480,-33,-1470,2086.2,-1072,76,-1465,1816.9,408,109,5,-269.3,,,
75,-1567,23,-1382,2089.5,-1147,128,-1383,1801.3,420,105,-1,-288.2,,,
76,-1557,51,-1377,2079.2,-1150,160,-1358,1786.7,407,109,19,-292.5,,,
77,-1555,71,-1377,2078.3,-1132,175,-1363,1780.4,423,104,14,-297.9,,,
78,-1527,66,-1392,2067.3,-1120,175,-1383,1788.2,407,109,9,-279.1,,,
79,-1517,93,-1395,2063.0,-1100,197,-1387,1781.2,417,104,8,-281.8,,,
80,-1482,71,-1415,2050.3,-1082,177,-1402,1779.8,400,106,13,-270.5,,,
81,-1477,61,-1435,2060.2,-1065,170,-1416,1779.9,412,109,19,-280.3,,,
82,-1442,58,-1447,2043.7,-1057,177,-1428,1785.4,385,119,19,-258.2,,,
83,-1442,68,-1475,2063.9,-1025,182,-1450,1785.0,417,114,25,-278.9,,,
84,-1432,53,-1476,2057.2,-1022,167,-1445,1777.8,410,114,31,-279.4,,,
85,-1400,78,-1475,2035.1,-1000,177,-1465,1782.6,400,99,10,-252.5,,,
86,-1400,73,-1486,2042.9,-987,165,-1478,1784.9,413,92,8,-258.0,,,
87,-1400,61,-1476,2035.3,-992,182,-1476,1787.7,408,121,0,-247.6,,,
88,-1410,71,-1476,2042.5,-1005,182,-1467,1787.5,405,111,9,-255.0,,,
89,-1407,78,-1472,2037.8,-1005,170,-1470,1788.8,402,92,2,-249.0,,,
90,-1427,53,-1483,2058.7,-1012,158,-1457,1781.0,415,105,26,-277.7,,,
91,-1437,61,-1483,2065.9,-1037,175,-1457,1796.9,400,114,26,-269.0,,,
92,-1430,31,-1496,2069.8,-1005,146,-1472,1788.3,425,115,24,-281.4,,,
93,-1420,16,-1503,2067.8,-1007,126,-1475,1790.4,413,110,28,-277.4,,,
94,-1435,18,-1488,2067.3,-1002,118,-1467,1780.5,433,100,21,-286.8,,,
95,-1412,18,-1478,2044.2,-1027,128,-1472,1799.4,385,110,6,-244.7,,,
96,-1427,-1,-1475,2052.3,-1025,106,-1475,1799.3,402,107,0,-253.0,,,
97,-1462,18,-1440,2052.2,-1050,126,-1416,1767.3,412,108,24,-284.8,,,
98,-1560,96,-1348,2064.0,-1130,180,-1330,1754.5,430,84,18,-309.5,,,
99,-1627,156,-1227,2043.8,-1210,280,-1198,1725.6,417,124,29,-318.2,,,
100,-1672,220,-1088,2006.9,-1275,358,-1068,1701.3,397,138,20,-305.6,,,
101,-1727,265,-1005,2015.6,-1318,393,-986,1692.3,409,128,19,-323.4,,,
102,-1725,295,-965,1998.5,-1326,421,-931,1674.0,399,126,34,-324.5,,,
103,-1722,300,-941,1985.1,-1323,423,-920,1666.0,399,123,21,-319.1,,,
104,-1740,318,-916,1991.9,-1331,448,-902,1669.1,409,130,14,-322.8,,,
105,-1725,371,-901,1981.2,-1311,495,-886,1657.9,414,124,15,-323.2,,,
106,-1720,386,-883,1971.6,-1306,515,-860,1646.3,414,129,23,-325.2,,,
107,-1722,426,-863,1972.7,-1316,552,-847,1659.5,406,126,16,-313.2,,,
108,-1712,461,-858,1969.7,-1311,585,-840,1663.3,401,124,18,-306.4,,,
109,-1682,507,-856,1954.2,-1298,635,-828,1665.4,384,128,28,-288.8,,,
110,-1680,535,-840,1953.0,-1286,666,-826,1667.2,394,131,14,-285.8,,,
111,-1695,520,-848,1965.3,-1301,663,-811,1670.3,394,143,37,-295.0,,,
112,-1725,567,-810,1988.3,-1321,683,-790,1683.9,404,116,20,-304.3,,,
113,-1687,627,-782,1962.3,-1301,746,-751,1677.2,386,119,31,-285.1,,,
114,-1717,638,-745,1977.4,-1343,766,-720,1705.5,374,128,25,-271.9,,,
115,-1755,600,-723,1990.7,-1348,726,-693,1680.6,407,126,30,-310.1,,,
116,-1745,592,-731,1982.4,-1353,723,-706,1688.7,392,131,25,-293.7,,,
117,-1747,592,-716,1978.7,-1368,728,-688,1695.5,379,136,28,-283.2,,,
118,-1752,646,-651,1977.5,-1371,773,-616,1690.2,381,127,35,-287.4,,,
119,-1787,651,-521,1972.0,-1413,797,-521,1703.9,374,146,0,-268.1,,,
120,-1845,658,-458,2011.7,-1458,778,-441,1710.4,387,120,17,-301.2,,,
121,-1895,607,-395,2028.7,-1516,746,-357,1726.9,379,139,38,-301.8,,,
122,-1945,545,-296,2041.5,-1581,711,-248,1751.2,364,166,48,-290.3,,,
123,-1980,515,-197,2055.3,-1605,666,-175,1746.5,375,151,22,-308.9,,,
124,-2010,492,-93,2071.4,-1635,635,-73,1755.5,375,143,20,-315.9,,,
125,-2055,396,-13,2092.8,-1680,540,3,1764.7,375,144,16,-328.2,,,
126,-2072,297,51,2093.8,-1715,428,83,1769.5,357,131,32,-324.3,,,
127,-2105,177,155,2118.1,-1727,331,160,1765.7,378,154,5,-352.4,,,
128,-2107,73,213,2119.0,-1725,217,261,1758.1,382,144,48,-360.9,,,
129,-2112,-16,243,2126.0,-1732,118,273,1757.3,380,134,30,-368.6,,,
130,-2130,-128,221,2145.3,-1750,28,246,1767.4,380,156,25,-377.8,,,
131,-2140,-290,150,2164.8,-1747,-111,172,1759.0,393,179,22,-405.8,,,
132,-2145,-572,-8,2220.0,-1752,-413,-1,1800.0,393,159,7,-420.0,,,
133,-2047,-952,-375,2288.5,-1640,-832,-365,1874.8,407,120,10,-413.6,,,
134,-1722,-1286,-950,2349.8,-1252,-1200,-957,1980.7,470,86,-7,-369.1,,,
135,-1025,-1428,-1543,2338.9,-530,-1356,-1535,2115.6,495,72,8,-223.3,,,
136,-507,-1502,-1738,2352.4,-23,-1413,-1691,2203.8,484,89,47,-148.6,,,
137,-97,-1445,-1812,2319.7,410,-1383,-1775,2287.2,507,62,37,-32.4,,,
138,67,-1406,-1802,2286.6,565,-1356,-1743,2279.5,498,50,59,-7.1,,,
139,50,-1353,-1783,2238.8,540,-1293,-1751,2242.6,490,60,32,3.8,,,
140,-137,-1306,-1791,2220.8,360,-1252,-1746,2178.4,497,54,45,-42.4,,,
141,-252,-1265,-1788,2204.7,241,-1190,-1760,2138.2,493,75,28,-66.5,,,
142,-320,-1137,-1822,2171.4,161,-1081,-1780,2088.8,481,56,42,-82.6,,,
143,-350,-976,-1895,2160.1,126,-917,-1858,2075.8,476,59,37,-84.3,,,
144,-402,-887,-1918,2151.1,83,-810,-1887,2055.2,485,77,31,-95.9,,,
145,-460,-743,-1953,2139.6,13,-653,-1918,2026.2,473,90,35,-113.4,,,
146,-507,-530,-1991,2121.8,-53,-466,-1950,2005.6,454,64,41,-116.2,,,
147,-565,-328,-2015,2118.3,-111,-275,-1983,2005.1,454,53,32,-113.2,,,
148,-577,-195,-2017,2107.0,-116,-108,-1983,1989.3,461,87,34,-117.6,,,
149,-635,-16,-2007,2105.1,-201,41,-1986,1996.6,434,57,21,-108.6,,,
150,-702,81,-1998,2119.3,-268,172,-1962,1987.7,434,91,36,-131.6,,,
151,-825,230,-1951,2130.7,-397,312,-1918,1983.3,428,82,33,-147.4,,,
152,-955,343,-1865,2123.2,-520,426,-1848,1966.5,435,83,17,-156.7,,,
153,-1120,386,-1768,2128.2,-698,477,-1760,1952.5,422,91,8,-175.7,,,
154,-1322,363,-1652,2146.8,-891,473,-1637,1922.9,431,110,15,-223.9,,,
155,-1432,348,-1568,2151.8,-997,443,-1546,1892.2,435,95,22,-259.6,,,
156,-1500,158,-1538,2154.2,-1092,262,-1527,1895.5,408,104,11,-258.7,,,
157,-1632,-38,-1455,2186.8,-1197,73,-1438,1872.4,435,111,17,-314.3,,,
158,-1660,-230,-1417,2194.6,-1230,-113,-1405,1870.7,430,117,12,-323.9,,,
159,-1650,-453,-1422,2224.8,-1210,-348,-1400,1882.9,440,105,22,-341.9,,,
160,-1600,-635,-1447,2248.8,-1135,-542,-1426,1901.4,465,93,21,-347.3,,,
161,-1500,-817,-1452,2241.8,-1060,-728,-1443,1932.8,440,89,9,-309.0,,,
162,-1417,-958,-1481,2262.5,-956,-877,-1470,1960.6,461,81,11,-301.9,,,
163,-1295,-1086,-1536,2283.8,-838,-978,-1506,1981.6,457,108,30,-302.2,,,
164,-1170,-1111,-1590,2265.2,-708,-1016,-1563,1994.1,462,95,27,-271.1,,,
165,-1020,-1112,-1652,2237.4,-560,-1043,-1650,2030.8,460,69,2,-206.7,,,
166,-927,-1135,-1716,2256.6,-455,-1058,-1691,2045.9,472,77,25,-210.7,,,
167,-862,-1101,-1756,2244.7,-380,-1031,-1721,2041.9,482,70,35,-202.9,,,
168,-797,-1041,-1788,2217.2,-322,-978,-1760,2039.1,475,63,28,-178.1,,,
169,-682,-996,-1830,2192.3,-201,-935,-1801,2039.2,481,61,29,-153.1,,,
170,-675,-1043,-1817,2201.1,-193,-968,-1767,2024.0,482,75,50,-177.1,,,
171,-815,-1115,-1713,2200.4,-362,-1051,-1671,2007.0,453,64,42,-193.5,,,
172,-1122,-1197,-1493,2218.3,-671,-1101,-1467,1953.1,451,96,26,-265.2,,,
173,-1385,-1175,-1276,2219.7,-956,-1076,-1258,1911.6,429,99,18,-308.1,,,
174,-1582,-1111,-1111,2229.7,-1132,-998,-1080,1855.8,450,113,31,-373.9,,,
175,-1700,-1066,-928,2210.8,-1262,-953,-928,1833.6,438,113,0,-377.2,,,
176,-1802,-1023,-755,2205.4,-1376,-905,-741,1806.0,426,118,14,-399.4,,,
177,-1872,-968,-633,2200.5,-1436,-832,-610,1768.2,436,136,23,-432.3,,,
178,-1862,-922,-641,2174.4,-1458,-802,-628,1778.6,404,120,13,-395.8,,,
179,-1880,-952,-643,2203.2,-1441,-835,-621,1777.5,439,117,22,-425.8,,,
180,-1845,-1041,-676,2223.7,-1423,-925,-670,1824.7,422,116,6,-399.0,,,
181,-1780,-1217,-780,2293.0,-1306,-1101,-785,1879.9,474,116,-5,-413.1,,,
182,-1645,-1341,-938,2320.4,-1162,-1242,-915,1931.3,483,99,23,-389.0,,,
183,-1452,-1331,-906,2168.1,-990,-1225,-888,1808.1,462,106,18,-360.0,,,
184,-1212,-1520,-843,2119.0,-741,-1428,-806,1799.4,471,92,37,-319.5,,,
185,-1015,-1603,-955,2124.1,-570,-1505,-922,1854.7,445,98,33,-269.4,,,
186,-1035,-1582,-1053,2164.0,-555,-1477,-1027,1882.6,480,105,26,-281.3,,,
187,-1285,-1391,-1035,2158.1,-846,-1291,-993,1835.3,439,100,42,-322.8,,,
188,-1560,-1111,-990,2155.9,-1127,-996,-948,1777.9,433,115,42,-378.0,,,
189,-1735,-797,-891,2107.0,-1311,-671,-868,1709.5,424,126,23,-397.5,,,
190,-1795,-625,-825,2072.0,-1368,-507,-826,1676.5,427,118,-1,-395.5,,,
191,-1827,-577,-825,2086.0,-1411,-448,-803,1684.2,416,129,22,-401.8,,,
192,-1787,-661,-863,2091.7,-1343,-545,-828,1669.2,444,116,35,-422.5,,,
193,-1647,-802,-992,2083.2,-1207,-706,-977,1705.8,440,96,15,-377.4,,,
194,-1597,-907,-992,2087.4,-1155,-800,-967,1705.6,442,107,25,-381.8,,,
195,-1567,-905,-1012,2073.3,-1132,-802,-991,1704.9,435,103,21,-368.4,,,
196,-1552,-825,-1056,2050.5,-1110,-738,-1035,1687.6,442,87,21,-362.9,,,
197,-1552,-600,-1148,2021.5,-1112,-530,-1128,1670.3,440,70,20,-351.3,,,
198,-1590,-220,-1146,1972.3,-1177,-96,-1142,1642.8,413,124,4,-329.5,,,
199,-1567,93,-1160,1951.9,-1152,230,-1145,1640.4,415,137,15,-311.4,,,
200,-1685,331,-970,1972.2,-1260,468,-922,1629.9,425,137,48,-342.3,,,
201,-1775,515,-590,1940.1,-1393,658,-568,1642.0,382,143,22,-298.1,,,
202,-1802,580,-350,1925.1,-1426,716,-337,1630.9,376,136,13,-294.3,,,
203,-1880,396,-296,1943.9,-1498,560,-277,1623.1,382,164,19,-320.9,,,
204,-1922,167,-407,1971.7,-1538,315,-376,1614.3,384,148,31,-357.4,,,
205,-1930,-21,-627,2029.4,-1526,88,-618,1648.7,404,109,9,-380.7,,,
206,-1852,-237,-888,2067.5,-1456,-143,-895,1715.1,396,94,-7,-352.5,,,
207,-1705,-408,-1156,2100.0,-1298,-285,-1116,1735.4,407,123,40,-364.6,,,
208,-1552,-560,-1293,2096.2,-1130,-433,-1272,1755.7,422,127,21,-340.6,,,
209,-1390,-706,-1390,2088.7,-941,-610,-1381,1779.0,449,96,9,-309.7,,,
210,-1322,-726,-1400,2057.9,-878,-627,-1361,1736.8,444,99,39,-321.1,,,
211,-1302,-661,-1368,2000.9,-878,-542,-1358,1705.5,424,119,10,-295.4,,,
212,-1280,-600,-1372,1970.0,-828,-490,-1361,1666.7,452,110,11,-303.2,,,
213,-1307,-595,-1318,1949.2,-876,-480,-1296,1636.3,431,115,22,-312.9,,,
214,-1367,-492,-1257,1921.1,-948,-386,-1233,1602.5,419,106,24,-318.7,,,
215,-1467,-371,-1153,1902.4,-1045,-257,-1133,1562.6,422,114,20,-339.8,,,
216,-1532,-212,-1103,1899.6,-1117,-96,-1077,1554.6,415,116,26,-345.0,,,
217,-1617,-28,-1007,1905.1,-1210,83,-975,1556.2,407,111,32,-349.0,,,
218,-1750,98,-723,1896.0,-1343,242,-732,1548.6,407,144,-9,-347.4,,,
219,-1785,222,-523,1873.2,-1411,353,-525,1546.3,374,131,-2,-326.9,,,
220,-1822,242,-402,1881.4,-1431,388,-365,1526.9,391,146,37,-354.5,,,
221,-1827,252,-316,1871.2,-1433,391,-287,1512.9,394,139,29,-358.3,,,
222,-1827,230,-236,1856.5,-1433,376,-215,1497.0,394,146,21,-359.5,,,
223,-1817,200,-226,1841.9,-1421,348,-206,1477.4,396,148,20,-364.5,,,
224,-1807,151,-286,1835.7,-1403,297,-271,1459.5,404,146,15,-376.2,,,
225,-1807,78,-342,1840.7,-1406,195,-307,1452.3,401,117,35,-388.5,,,
226,-1807,1,-362,1842.9,-1406,128,-333,1450.6,401,127,29,-392.3,,,
227,-1797,-48,-365,1834.3,-1406,96,-352,1452.6,391,144,13,-381.8,,,
228,-1827,-88,-352,1862.7,-1421,33,-357,1465.5,406,121,-5,-397.1,,,
229,-1855,-185,-296,1887.6,-1448,-61,-285,1477.0,407,124,11,-410.5,,,
230,-1860,-220,-301,1897.0,-1471,-101,-292,1503.1,389,119,9,-393.9,,,
231,-1875,-300,-320,1925.6,-1471,-185,-307,1514.0,404,115,13,-411.6,,,
232,-1870,-333,-382,1937.5,-1468,-212,-368,1528.2,402,121,14,-409.3,,,
233,-1870,-346,-428,1949.3,-1456,-232,-427,1535.0,414,114,1,-414.4,,,
234,-1865,-356,-506,1964.9,-1451,-227,-490,1548.2,414,129,16,-416.7,,,
235,-1857,-333,-540,1962.4,-1448,-200,-525,1553.2,409,133,15,-409.2,,,
236,-1827,-341,-575,1945.5,-1433,-235,-556,1554.9,394,106,19,-390.5,,,
237,-1812,-356,-527,1920.4,-1421,-232,-532,1535.0,391,124,-5,-385.4,,,
238,-1817,-381,-476,1916.6,-1408,-267,-475,1509.8,409,114,1,-406.8,,,
239,-1800,-416,-433,1897.5,-1391,-300,-402,1478.7,409,116,31,-418.8,,,
240,-1762,-436,-395,1857.6,-1366,-315,-378,1451.9,396,121,17,-405.7,,,
241,-1752,-418,-372,1839.2,-1336,-305,-376,1421.0,416,113,-4,-418.2,,,
242,-1685,-371,-516,1800.9,-1275,-247,-530,1402.7,410,124,-14,-398.2,,,
243,-1560,-315,-817,1788.9,-1130,-200,-801,1399.5,430,115,16,-389.5,,,
244,-1320,-302,-1103,1746.5,-883,-185,-1077,1404.9,437,117,26,-341.6,,,
245,-932,-317,-1311,1639.5,-485,-230,-1290,1397.2,447,87,21,-242.2,,,
246,-475,-338,-1397,1513.8,-38,-245,-1361,1383.4,437,93,36,-130.4,,,
247,-37,-282,-1331,1361.0,415,-207,-1275,1356.7,452,75,56,-4.3,,,
248,302,-180,-1192,1242.8,761,-118,-1147,1381.5,459,62,45,138.8,,,
249,490,-165,-1063,1182.1,936,-91,-1020,1387.4,446,74,43,205.3,,,
250,640,-138,-931,1138.2,1090,-76,-881,1403.6,450,62,50,265.4,,,
251,735,-210,-830,1128.4,1182,-146,-782,1424.8,447,64,48,296.4,,,
252,732,-378,-851,1184.4,1180,-307,-797,1456.7,448,71,54,272.2,,,
253,565,-570,-1000,1282.2,997,-517,-933,1460.1,432,53,67,177.8,,,
254,320,-643,-1153,1358.4,753,-567,-1116,1460.8,433,76,37,102.4,,,
255,-27,-602,-1318,1449.2,390,-530,-1291,1449.0,417,72,27,-0.2,,,
256,-395,-416,-1402,1514.8,53,-323,-1381,1419.3,448,93,21,-95.6,,,
257,-632,-126,-1377,1520.3,-183,-26,-1366,1378.4,449,100,11,-141.9,,,
258,-772,160,-1311,1529.8,-335,265,-1262,1332.3,437,105,49,-197.5,,,
259,-785,500,-1158,1485.7,-387,585,-1121,1322.4,398,85,37,-163.3,,,
260,-737,766,-970,1439.0,-335,875,-926,1317.3,402,109,44,-121.7,,,
261,-640,973,-742,1380.9,-261,1088,-698,1318.7,379,115,44,-62.2,,,
262,-600,1108,-473,1345.9,-213,1210,-456,1310.5,387,102,17,-35.4,,,
263,-620,1172,-226,1345.0,-228,1286,-213,1323.3,392,114,13,-21.7,,,
264,-710,1152,1,1353.2,-342,1273,37,1318.7,368,121,36,-34.6,,,
265,-810,1088,238,1377.1,-455,1217,287,1330.6,355,129,49,-46.5,,,
266,-932,971,438,1415.4,-580,1096,458,1321.9,352,125,20,-93.5,,,
267,-965,847,592,1413.9,-605,973,618,1301.8,360,126,26,-112.1,,,
268,-1012,713,740,1442.3,-648,827,772,1303.8,364,114,32,-138.5,,,
269,-1015,570,876,1456.9,-641,683,897,1296.9,374,113,21,-160.0,,,
270,-1005,381,985,1457.9,-637,517,1011,1302.0,368,136,26,-155.9,,,
271,-947,177,1053,1427.2,-562,310,1073,1250.3,385,133,20,-176.9,,,
272,-895,-18,1017,1354.9,-545,113,1063,1199.9,350,131,46,-155.0,,,
273,-887,-250,938,1315.0,-507,-83,980,1106.5,380,167,42,-208.5,,,
274,-805,-398,807,1207.3,-420,-255,840,973.2,385,143,33,-234.2,,,
275,-692,-505,638,1068.1,-318,-378,636,805.3,374,127,-2,-262.8,,,
276,-632,-565,456,962.6,-271,-433,485,704.4,361,132,29,-258.2,,,
277,-640,-602,177,896.3,-248,-428,225,543.4,392,174,48,-352.9,,,
278,-750,-446,66,875.1,-335,-262,123,442.7,415,184,57,-432.4,,,
279,-860,-317,251,950.3,-430,-158,277,535.3,430,159,26,-415.0,,,
280,-982,-466,410,1161.7,-557,-312,456,784.6,425,154,46,-377.2,,,
281,-1107,-651,417,1350.2,-688,-535,462,986.4,419,116,45,-363.8,,,
282,-1205,-825,322,1495.4,-786,-673,347,1091.4,419,152,25,-404.0,,,
283,-1260,-887,233,1558.4,-831,-751,248,1147.2,429,136,15,-411.2,,,
284,-1255,-961,56,1581.7,-831,-835,92,1181.6,424,126,36,-400.0,,,
285,-1222,-986,-155,1577.8,-803,-882,-115,1198.3,419,104,40,-379.5,,,
286,-1160,-952,-335,1537.6,-748,-865,-307,1184.1,412,87,28,-353.5,,,
287,-1075,-920,-530,1510.9,-661,-817,-493,1160.8,414,103,37,-350.1,,,
288,-1065,-827,-615,1482.0,-625,-723,-595,1125.8,440,104,20,-356.2,,,
289,-1035,-703,-750,1458.7,-622,-625,-710,1132.1,413,78,40,-326.7,,,
290,-1035,-565,-837,1446.0,-617,-463,-821,1126.5,418,102,16,-319.5,,,
291,-1020,-418,-957,1459.8,-600,-321,-922,1145.9,420,97,35,-313.9,,,
292,-1092,-292,-1000,1509.2,-666,-202,-965,1189.8,426,90,35,-319.4,,,
293,-1175,-160,-1010,1557.7,-781,-41,-970,1246.0,394,119,40,-311.7,,,
294,-1257,-88,-1020,1621.2,-843,8,-972,1286.7,414,96,48,-334.5,,,
295,-1370,-56,-967,1677.8,-931,26,-952,1331.8,439,82,15,-346.0,,,
296,-1455,-83,-921,1724.0,-1025,31,-888,1356.5,430,114,33,-367.5,,,
297,-1462,-43,-908,1721.6,-1040,63,-866,1354.8,422,106,42,-366.7,,,
298,-1512,-1,-846,1732.6,-1082,111,-797,1348.4,430,112,49,-384.2,,,
299,-1562,165,-762,1745.8,-1135,280,-717,1371.4,427,115,45,-374.4,,,
300,-1577,371,-641,1742.3,-1167,522,-605,1414.4,410,151,36,-327.9,,,
301,-1547,600,-466,1723.5,-1150,736,-393,1420.8,397,136,73,-302.7,,,
302,-1532,723,-152,1700.8,-1160,865,-136,1453.4,372,142,16,-247.5,,,
303,-1440,835,41,1665.1,-1077,956,71,1441.8,363,121,30,-223.2,,,
304,-1422,815,197,1650.8,-1040,947,230,1425.2,382,132,33,-225.6,,,
305,-1380,795,320,1624.4,-1000,925,342,1404.5,380,130,22,-220.0,,,
306,-1365,691,473,1601.4,-997,830,487,1385.7,368,139,14,-215.7,,,
307,-1397,530,537,1587.7,-1025,678,581,1359.4,372,148,44,-228.4,,,
308,-1410,328,653,1588.1,-1012,476,696,1317.2,398,148,43,-270.9,,,
309,-1385,158,752,1583.9,-1000,300,782,1304.4,385,142,30,-279.5,,,
310,-1367,-28,830,1599.5,-972,116,863,1305.0,395,144,33,-294.5,,,
311,-1335,-210,871,1607.8,-943,-63,895,1301.6,392,147,24,-306.2,,,
312,-1340,-353,851,1626.2,-941,-217,878,1305.2,399,136,27,-321.0,,,
313,-1382,-542,760,1667.7,-980,-406,795,1325.6,402,136,35,-342.1,,,
314,-1467,-693,600,1729.8,-1075,-547,621,1356.6,392,146,21,-373.2,,,
315,-1597,-738,342,1792.2,-1197,-602,357,1386.6,400,136,15,-405.6,,,
316,-1687,-728,-3,1837.4,-1288,-592,-1,1417.5,399,136,2,-419.8,,,
317,-1720,-555,-488,1872.0,-1298,-451,-415,1435.4,422,104,73,-436.6,,,
318,-1587,-245,-843,1813.6,-1192,-167,-790,1439.7,395,78,53,-373.9,,,
319,-1300,101,-1123,1720.9,-883,210,-1090,1418.4,417,109,33,-302.4,,,
320,-937,376,-1255,1610.7,-490,468,-1230,1404.3,447,92,25,-206.4,,,
321,-562,436,-1366,1540.1,-151,532,-1308,1420.1,411,96,58,-120.0,,,
322,-285,388,-1445,1523.1,153,441,-1410,1485.3,438,53,35,-37.8,,,
323,-90,121,-1556,1563.3,330,180,-1507,1553.2,420,59,49,-10.1,,,
324,-52,-190,-1615,1627.0,372,-128,-1572,1620.5,424,62,43,-6.5,,,
325,-232,-373,-1622,1680.4,213,-315,-1585,1630.0,445,58,37,-50.5,,,
326,-392,-416,-1622,1719.8,53,-328,-1577,1611.6,445,88,45,-108.1,,,
327,-560,-252,-1582,1697.0,-128,-170,-1566,1580.4,432,82,16,-116.6,,,
328,-795,21,-1501,1698.7,-322,93,-1491,1528.2,473,72,10,-170.5,,,
329,-937,252,-1356,1667.4,-515,338,-1350,1483.9,422,86,6,-183.5,,,
330,-1135,373,-1165,1668.7,-746,476,-1126,1432.1,389,103,39,-236.6,,,
331,-1280,453,-982,1675.7,-871,580,-972,1428.2,409,127,10,-247.5,,,
332,-1330,600,-825,1676.2,-941,721,-808,1434.6,389,121,17,-241.5,,,
333,-1377,761,-622,1691.8,-975,900,-581,1448.5,402,139,41,-243.3,,,
334,-1355,905,-451,1690.7,-995,1021,-415,1484.8,360,116,36,-205.9,,,
335,-1357,971,-306,1696.4,-977,1111,-282,1506.1,380,140,24,-190.3,,,
336,-1285,1086,-213,1695.9,-906,1215,-172,1525.3,379,129,41,-170.5,,,
337,-1190,1197,-147,1694.3,-806,1341,-128,1569.8,384,144,19,-124.5,,,
338,-1110,1298,-26,1708.1,-723,1423,0,1596.1,387,125,26,-112.0,,,
339,-1012,1366,125,1704.6,-646,1492,146,1632.4,366,126,21,-72.2,,,
340,-897,1338,511,1690.0,-550,1485,506,1662.5,347,147,-5,-27.5,,,
341,-700,1111,1027,1667.0,-330,1217,1116,1683.9,370,106,89,16.8,,,
342,-355,575,1488,1634.3,6,678,1535,1678.1,361,103,47,43.8,,,
343,-125,16,1615,1619.9,253,128,1655,1679.1,378,112,40,59.2,,,
344,-40,-653,1508,1643.8,350,-590,1543,1688.6,390,63,35,44.8,,,
345,-85,-1273,1160,1724.3,318,-1175,1207,1714.2,403,98,47,-10.1,,,
346,-305,-1613,757,1807.7,141,-1525,798,1726.9,446,88,41,-80.8,,,
347,-600,-1741,478,1902.5,-163,-1626,498,1708.3,437,115,20,-194.2,,,
348,-1002,-1668,210,1957.1,-582,-1560,261,1685.4,420,108,51,-271.8,,,
349,-1382,-1455,46,2007.3,-975,-1336,83,1656.0,407,119,37,-351.2,,,
350,-1732,-1083,-162,2049.1,-1298,-971,-126,1625.9,434,112,36,-423.2,,,
351,-1920,-605,-362,2045.4,-1498,-507,-318,1613.1,422,98,44,-432.2,,,
352,-1885,-143,-676,2007.6,-1471,-16,-657,1611.1,414,127,19,-396.5,,,
353,-1587,217,-1101,1943.7,-1175,343,-1077,1630.4,412,126,24,-313.3,,,
354,-1340,383,-1265,1882.2,-936,505,-1260,1648.9,404,122,5,-233.3,,,
355,-1142,527,-1368,1858.3,-726,627,-1353,1658.6,416,100,15,-199.8,,,
356,-1047,641,-1385,1850.8,-632,753,-1345,1666.0,415,112,40,-184.8,,,
357,-1035,731,-1323,1831.9,-637,825,-1301,1667.0,398,94,22,-164.9,,,
358,-1022,795,-1303,1836.9,-612,905,-1260,1667.7,410,110,43,-169.2,,,
359,-960,932,-1217,1808.7,-562,1021,-1200,1672.8,398,89,17,-135.9,,,
360,-800,1051,-1182,1772.5,-402,1147,-1147,1671.2,398,96,35,-101.3,,,
361,-610,1187,-1045,1695.0,-241,1291,-1020,1662.9,369,104,25,-32.1,,,
362,-482,1270,-982,1676.2,-113,1373,-936,1665.5,369,103,46,-10.6,,,
363,-235,1267,-1022,1644.7,183,1351,-983,1680.8,418,84,39,36.1,,,
364,65,1245,-1000,1598.2,467,1326,-946,1694.5,402,81,54,96.3,,,
365,160,1230,-980,1580.8,557,1316,-923,1701.2,397,86,57,120.4,,,
366,165,1281,-868,1556.2,560,1378,-818,1697.5,395,97,50,141.4,,,
367,162,1416,-648,1565.6,550,1497,-605,1705.7,388,81,43,140.1,,,
368,102,1550,-258,1574.6,460,1643,-186,1716.3,358,93,72,141.7,,,
369,15,1530,355,1570.7,375,1621,438,1720.5,360,91,83,149.8,,,
370,-237,1270,901,1575.1,98,1371,982,1689.3,335,101,81,114.2,,,
371,-800,751,1205,1629.7,-467,885,1256,1605.9,333,134,51,-23.9,,,
372,-1430,182,1045,1780.5,-1015,381,1108,1550.2,415,199,63,-230.3,,,
373,-1877,-180,421,1932.0,-1471,-13,490,1550.5,406,167,69,-381.5,,,
374,-1975,-287,-263,2013.0,-1583,-131,-242,1606.7,392,156,21,-406.3,,,
375,-1852,-250,-752,2014.4,-1451,-116,-717,1622.6,401,134,35,-391.8,,,
376,-1712,-207,-1035,2011.2,-1272,-76,-1013,1627.9,440,131,22,-383.4,,,
377,-1517,-167,-1242,1967.7,-1085,-51,-1233,1643.2,432,116,9,-324.5,,,
378,-1210,-103,-1472,1908.3,-781,0,-1445,1642.6,429,103,27,-265.7,,,
379,-992,-48,-1568,1856.1,-570,36,-1525,1628.4,422,84,43,-227.6,,,
380,-772,-31,-1637,1810.2,-325,56,-1606,1639.5,447,87,31,-170.7,,,
381,-627,-13,-1632,1748.3,-196,61,-1623,1635.9,431,74,9,-112.4,,,
382,-795,48,-1578,1767.6,-385,158,-1543,1598.1,410,110,35,-169.5,,,
383,-1047,416,-1368,1772.2,-612,490,-1373,1581.1,435,74,-5,-191.1,,,
384,-1185,701,-1081,1750.5,-778,793,-1087,1554.3,407,92,-6,-196.2,,,
385,-1185,887,-898,1731.3,-798,996,-863,1540.6,387,109,35,-190.7,,,
386,-1145,988,-805,1713.2,-741,1098,-768,1531.2,404,110,37,-182.1,,,
387,-1050,1071,-765,1683.7,-651,1195,-737,1547.6,399,124,28,-136.1,,,
388,-1057,1122,-651,1673.3,-678,1230,-616,1533.6,379,108,35,-139.7,,,
389,-1092,1175,-402,1653.7,-716,1296,-368,1525.7,376,121,34,-128.0,,,
390,-1090,1215,-122,1636.8,-716,1358,-86,1537.6,374,143,36,-99.2,,,
391,-1042,1200,266,1611.4,-676,1326,305,1519.3,366,126,39,-92.1,,,
392,-922,1150,547,1572.2,-550,1286,600,1521.9,372,136,53,-50.3,,,
393,-732,1101,762,1526.0,-375,1232,792,1511.9,357,131,30,-14.1,,,
394,-607,1031,878,1484.0,-256,1162,917,1502.2,351,131,39,18.2,,,
395,-517,976,903,1426.6,-176,1103,957,1470.9,341,127,54,44.2,,,
396,-492,885,938,1380.3,-131,1023,983,1424.8,361,138,45,44.5,,,
397,-545,736,992,1350.1,-211,867,1045,1374.1,334,131,53,24.0,,,
398,-645,565,1045,1351.8,-266,696,1087,1317.9,379,131,42,-33.9,,,
399,-675,403,1073,1330.2,-318,542,1121,1285.1,357,139,48,-45.1,,,
400,-785,170,1083,1348.3,-412,312,1128,1240.8,373,142,45,-107.6,,,
401,-952,0,1047,1415.1,-585,121,1066,1222.0,367,121,19,-193.1,,,
402,-1182,-270,891,1504.6,-813,-138,905,1224.4,369,132,14,-280.3,,,
403,-1447,-585,483,1633.8,-1050,-443,513,1249.8,397,142,30,-384.0,,,
404,-1577,-681,11,1717.8,-1160,-535,28,1277.7,417,146,17,-440.1,,,
405,-1580,-612,-375,1735.4,-1157,-490,-326,1298.1,423,122,49,-437.3,,,
406,-1540,-520,-577,1724.8,-1117,-396,-552,1307.4,423,124,25,-417.4,,,
407,-1477,-446,-770,1724.3,-1047,-331,-748,1328.6,430,115,22,-395.7,,,
408,-1407,-388,-911,1720.5,-980,-275,-900,1358.7,427,113,11,-361.8,,,
409,-1252,-310,-1123,1710.2,-828,-207,-1105,1396.2,424,103,18,-314.0,,,
410,-1120,-217,-1266,1704.2,-691,-111,-1230,1415.2,429,106,36,-289.0,,,
411,-1110,-91,-1288,1702.7,-656,6,-1258,1418.8,454,97,30,-284.0,,,
412,-1127,153,-1265,1701.1,-706,245,-1222,1432.4,421,92,43,-268.7,,,
413,-1252,482,-1000,1673.3,-841,595,-982,1423.2,411,113,18,-250.0,,,
414,-1377,698,-585,1650.9,-987,825,-542,1395.9,390,127,43,-255.0,,,
415,-1447,746,-233,1644.6,-1082,880,-203,1409.4,365,134,30,-235.2,,,
416,-1415,748,231,1617.1,-1052,882,242,1394.0,363,134,11,-223.1,,,
417,-1430,627,486,1635.3,-1072,795,496,1423.8,358,168,10,-211.5,,,
418,-1405,532,681,1649.5,-1040,658,725,1428.4,365,126,44,-221.1,,,
419,-1402,353,832,1668.1,-1047,500,863,1446.0,355,147,31,-222.0,,,
420,-1612,143,663,1748.9,-1265,287,681,1465.0,347,144,18,-283.8,,,
421,-1790,0,335,1821.1,-1413,151,362,1466.4,377,151,27,-354.6,,,
422,-1852,-23,-157,1858.8,-1456,91,-146,1466.1,396,114,11,-392.7,,,
423,-1585,56,-913,1830.0,-1187,170,-876,1485.0,398,114,37,-345.0,,,
424,-1017,156,-1377,1718.9,-607,262,-1368,1519.4,410,106,9,-199.6,,,
425,-677,103,-1521,1668.0,-258,180,-1483,1516.0,419,77,38,-152.0,,,
426,-915,-86,-1452,1718.4,-482,18,-1416,1495.9,433,104,36,-222.5,,,
427,-1400,-180,-1118,1800.6,-936,-56,-1126,1465.3,464,124,-8,-335.3,,,
428,-1712,-230,-600,1828.6,-1283,-98,-610,1424.0,429,132,-10,-404.6,,,
429,-1785,-237,26,1800.9,-1386,-106,52,1391.0,399,131,26,-409.8,,,
430,-1570,-190,658,1712.9,-1170,-51,672,1350.2,400,139,14,-362.7,,,
431,-1177,-58,1037,1569.7,-786,68,1076,1334.2,391,126,39,-235.5,,,
432,-945,-33,1156,1493.5,-570,93,1191,1323.6,375,126,35,-169.8,,,
433,-1232,-207,941,1564.0,-828,-56,972,1278.1,404,151,31,-285.9,,,
434,-1532,-393,491,1656.1,-1140,-257,518,1278.3,392,136,27,-377.8,,,
435,-1617,-610,-73,1729.8,-1205,-476,-57,1296.9,412,134,16,-432.9,,,
436,-1395,-728,-693,1719.4,-962,-612,-655,1314.9,433,116,38,-404.5,,,
437,-1055,-738,-1027,1646.9,-582,-643,-1001,1324.5,473,95,26,-322.5,,,
438,-635,-753,-1172,1531.0,-216,-676,-1140,1342.8,419,77,32,-188.1,,,
439,-490,-783,-1172,1492.2,-51,-678,-1121,1311.1,439,105,51,-181.2,,,
440,-402,-860,-1086,1442.4,33,-793,-1056,1321.0,435,67,30,-121.4,,,
441,-477,-900,-1056,1467.2,-26,-820,-1008,1299.7,451,80,48,-167.5,,,
442,-695,-917,-997,1522.5,-258,-822,-943,1277.3,437,95,54,-245.2,,,
443,-962,-865,-923,1589.2,-517,-761,-888,1278.7,445,104,35,-310.6,,,
444,-1242,-656,-810,1621.4,-833,-522,-780,1254.9,409,134,30,-366.5,,,
445,-1500,-287,-610,1644.5,-1095,-167,-576,1248.5,405,120,34,-396.1,,,
446,-1562,53,-426,1619.9,-1152,182,-393,1230.7,410,129,33,-389.2,,,
447,-1545,295,-202,1585.8,-1172,443,-153,1262.2,373,148,49,-323.6,,,
448,-1525,383,68,1573.8,-1122,500,112,1233.5,403,117,44,-340.4,,,
449,-1472,353,320,1547.2,-1097,487,328,1244.3,375,134,8,-302.9,,,
450,-1437,170,508,1533.6,-1052,341,516,1220.3,385,171,8,-313.3,,,
451,-1382,-56,671,1537.3,-992,56,706,1218.9,390,112,35,-318.4,,,
452,-1325,-331,731,1549.0,-941,-192,730,1206.3,384,139,-1,-342.7,,,
453,-1277,-607,661,1560.8,-848,-476,686,1190.1,429,131,25,-370.7,,,
454,-1170,-825,545,1531.8,-756,-701,566,1176.1,414,124,21,-355.7,,,
455,-1105,-981,390,1528.2,-683,-857,431,1177.6,422,124,41,-350.6,,,
456,-1060,-1096,213,1539.5,-632,-971,245,1184.2,428,125,32,-355.4,,,
457,-1062,-1140,21,1558.2,-643,-1023,57,1209.6,419,117,36,-348.5,,,
458,-1115,-1120,-216,1595.1,-686,-1013,-193,1238.6,429,107,23,-356.5,,,
459,-1125,-1053,-461,1608.4,-696,-942,-422,1244.9,429,111,39,-363.5,,,
460,-1147,-968,-615,1622.0,-713,-880,-595,1279.4,434,88,20,-342.6,,,
461,-1145,-867,-797,1642.5,-716,-766,-753,1290.9,429,101,44,-351.6,,,
462,-1105,-786,-901,1628.1,-686,-683,-868,1300.2,419,103,33,-327.9,,,
463,-1102,-738,-948,1630.3,-661,-643,-922,1304.0,441,95,26,-326.2,,,
464,-1030,-615,-1053,1596.2,-605,-517,-1032,1303.2,425,98,21,-293.0,,,
465,-810,-441,-1220,1529.4,-367,-336,-1202,1300.9,443,105,18,-228.5,,,
466,-557,-477,-1271,1467.4,-123,-393,-1243,1309.4,434,84,28,-157.9,,,
467,-440,-575,-1257,1450.6,3,-482,-1222,1313.6,443,93,35,-137.0,,,
468,-585,-656,-1202,1489.1,-143,-580,-1165,1309.2,442,76,37,-179.9,,,
469,-787,-597,-1133,1503.2,-340,-510,-1095,1254.9,447,87,38,-248.3,,,
470,-1035,-346,-1086,1539.6,-607,-250,-1063,1249.4,428,96,23,-290.2,,,
471,-1147,-61,-1027,1540.8,-726,51,-1011,1245.7,421,112,16,-295.1,,,
472,-1257,315,-846,1547.6,-836,398,-837,1248.1,421,83,9,-299.4,,,
473,-1252,575,-671,1532.4,-868,706,-628,1283.1,384,131,43,-249.4,,,
474,-1225,728,-570,1534.8,-826,852,-532,1300.5,399,124,38,-234.3,,,
475,-1237,810,-508,1563.4,-846,932,-475,1345.3,391,122,33,-218.1,,,
476,-1307,793,-420,1585.4,-936,935,-376,1375.4,371,142,44,-210.0,,,
477,-1422,763,-288,1639.3,-1040,890,-251,1391.7,382,127,37,-247.6,,,
478,-1567,627,-120,1692.0,-1195,758,-78,1417.3,372,131,42,-274.8,,,
479,-1717,356,122,1757.8,-1346,476,151,1435.7,371,120,29,-322.1,,,
480,-1810,-103,283,1834.9,-1431,43,308,1464.4,379,146,25,-370.5,,,
481,-1807,-605,303,1929.5,-1398,-461,321,1506.6,409,144,18,-422.9,,,
482,-1710,-1016,117,1992.5,-1288,-817,188,1536.8,422,199,71,-455.7,,,
483,-1600,-1182,-400,2029.1,-1177,-1066,-313,1618.5,423,116,87,-410.5,,,
484,-1470,-981,-921,1992.9,-1037,-847,-922,1625.7,433,134,-1,-367.2,,,
485,-1350,-641,-1262,1956.0,-911,-517,-1231,1616.3,439,124,31,-339.7,,,
486,-1235,-441,-1422,1934.4,-776,-331,-1395,1630.3,459,110,27,-304.1,,,
487,-1052,-368,-1531,1893.7,-617,-285,-1507,1653.2,435,83,24,-240.5,,,
488,-802,-456,-1642,1883.4,-360,-376,-1606,1688.3,442,80,36,-195.2,,,
489,-702,-612,-1670,1912.1,-253,-537,-1635,1739.4,449,75,35,-172.7,,,
490,-725,-778,-1597,1918.7,-261,-678,-1580,1739.0,464,100,17,-179.7,,,
491,-732,-832,-1585,1934.0,-263,-738,-1551,1737.6,469,94,34,-196.3,,,
492,-955,-817,-1470,1934.0,-512,-711,-1443,1688.2,443,106,27,-245.8,,,
493,-1220,-471,-1397,1913.6,-763,-388,-1383,1626.5,457,83,14,-287.1,,,
494,-1402,-81,-1271,1894.1,-962,-6,-1262,1586.9,440,75,9,-307.2,,,
495,-1542,305,-1020,1873.8,-1142,416,-1001,1574.6,400,111,19,-299.3,,,
496,-1602,570,-755,1860.5,-1205,711,-738,1581.8,397,141,17,-278.6,,,
497,-1622,746,-521,1859.8,-1240,885,-462,1591.9,382,139,59,-267.9,,,
498,-1722,723,-172,1875.5,-1343,862,-126,1600.8,379,139,46,-274.7,,,
499,-1830,550,137,1915.8,-1451,696,172,1618.5,379,146,35,-297.3,,,
500,-1920,255,360,1970.0,-1553,391,388,1647.8,367,136,28,-322.2,,,
501,-2025,-290,355,2076.2,-1635,-108,371,1680.0,390,182,16,-396.2,,,
502,-1987,-726,202,2125.1,-1593,-605,220,1718.2,394,121,18,-406.9,,,
503,-1955,-925,-165,2169.1,-1536,-793,-141,1734.4,419,132,24,-434.7,,,
504,-1920,-897,-523,2182.8,-1501,-768,-448,1744.6,419,129,75,-438.2,,,
505,-1812,-651,-948,2146.1,-1416,-550,-857,1744.1,396,101,91,-402.0,,,
506,-1630,-343,-1245,2079.6,-1212,-235,-1236,1747.0,418,108,9,-332.6,,,
507,-1455,-123,-1432,2045.2,-1020,-13,-1421,1749.2,435,110,11,-296.0,,,
508,-1225,-28,-1607,2020.9,-781,78,-1570,1755.3,444,106,37,-265.6,,,
509,-982,-71,-1756,2013.2,-542,18,-1717,1800.6,440,89,39,-212.6,,,
510,-807,-232,-1837,2019.8,-365,-143,-1808,1850.0,442,89,29,-169.8,,,
511,-862,-252,-1832,2040.3,-430,-158,-1798,1855.4,432,94,34,-184.8,,,
512,-895,-158,-1805,2020.9,-462,-66,-1772,1832.4,433,92,33,-188.5,,,
513,-1150,-33,-1655,2015.6,-736,76,-1623,1783.7,414,109,32,-231.9,,,
514,-1400,172,-1452,2024.3,-972,292,-1436,1758.4,428,120,16,-265.9,,,
515,-1575,456,-1158,2007.4,-1155,545,-1150,1718.6,420,89,8,-288.8,,,
516,-1715,587,-827,1992.4,-1298,678,-842,1689.2,417,91,-15,-303.2,,,
517,-1755,701,-550,1968.2,-1383,822,-535,1695.5,372,121,15,-272.8,,,
518,-1800,713,-357,1968.7,-1433,842,-355,1699.6,367,129,2,-269.2,,,
519,-1920,540,-210,2005.5,-1553,673,-198,1704.1,367,133,12,-301.4,,,
520,-2057,245,-155,2077.3,-1675,371,-136,1721.0,382,126,19,-356.4,,,
521,-2137,-212,-41,2147.9,-1752,-71,-21,1753.6,385,141,20,-394.3,,,
522,-2125,-693,-238,2247.8,-1717,-570,-240,1825.0,408,123,-2,-422.8,,,
523,-1982,-910,-711,2293.9,-1563,-771,-720,1885.7,419,139,-9,-408.2,,,
524,-1782,-882,-1175,2309.6,-1328,-793,-1176,1943.0,454,89,-1,-366.5,,,
525,-1547,-837,-1450,2279.5,-1112,-748,-1457,1979.6,435,89,-7,-299.9,,,
526,-1552,-748,-1470,2264.8,-1110,-651,-1450,1938.7,442,97,20,-326.1,,,
527,-1652,-562,-1427,2254.2,-1197,-473,-1421,1917.2,455,89,6,-336.9,,,
528,-1800,-446,-1288,2257.8,-1378,-336,-1275,1907.2,422,110,13,-350.6,,,
529,-1890,-463,-1185,2278.3,-1471,-356,-1176,1916.7,419,107,9,-361.7,,,
530,-1870,-560,-1227,2305.7,-1456,-436,-1207,1940.8,414,124,20,-364.8,,,
531,-1730,-703,-1390,2327.9,-1316,-597,-1376,1995.4,414,106,14,-332.5,,,
532,-1535,-678,-1587,2309.6,-1077,-565,-1587,1999.4,458,113,0,-310.2,,,
533,-1312,-625,-1733,2261.7,-851,-535,-1712,1985.3,461,90,21,-276.4,,,
534,-1110,-562,-1810,2196.4,-651,-468,-1788,1959.5,459,94,22,-236.8,,,
535,-1035,-487,-1815,2145.4,-587,-391,-1782,1916.5,448,96,33,-228.9,,,
536,-1045,-480,-1773,2113.3,-595,-396,-1755,1895.0,450,84,18,-218.3,,,
537,-1052,-555,-1731,2100.3,-600,-458,-1692,1852.7,452,97,39,-247.5,,,
538,-925,-627,-1746,2073.0,-500,-520,-1717,1862.4,425,107,29,-210.6,,,
539,-970,-723,-1768,2142.3,-520,-622,-1723,1904.2,450,101,45,-238.1,,,
540,-787,-635,-1887,2140.9,-320,-545,-1856,1960.7,467,90,31,-180.2,,,
541,-742,-728,-2020,2271.8,-256,-635,-1988,2102.6,486,93,32,-169.2,,,
542,-657,-788,-2141,2374.1,-146,-716,-2132,2253.8,511,72,9,-120.4,,,
543,-657,-793,-2232,2458.1,-136,-746,-2233,2358.2,521,47,-1,-99.9,,,
544,-860,-1018,-2133,2515.1,-337,-976,-2153,2387.8,523,42,-20,-127.3,,,
545,-915,-890,-2027,2395.4,-440,-845,-2062,2271.4,475,45,-35,-124.0,,,
546,-1202,-915,-1763,2321.7,-826,-880,-1786,2155.6,376,35,-23,-166.1,,,
547,-1307,-1006,-1647,2330.9,-908,-956,-1663,2122.3,399,50,-16,-208.6,,,
548,-1430,-537,-1721,2301.1,-1067,-530,-1767,2131.1,363,7,-46,-170.0,,,
549,-1467,-111,-1711,2256.5,-1105,-38,-1752,2071.7,362,73,-41,-184.8,,,
550,-1467,-11,-1662,2216.9,-1140,76,-1736,2078.2,327,87,-74,-138.6,,,
551,-1477,-6,-1686,2241.5,-1137,83,-1741,2081.0,340,89,-55,-160.4,,,
552,-1470,-13,-1686,2236.9,-1132,81,-1733,2071.5,338,94,-47,-165.3,,,
553,-1465,-18,-1691,2237.4,-1132,68,-1755,2089.5,333,86,-64,-147.9,,,
554,-1465,-11,-1696,2241.2,-1132,83,-1733,2071.6,333,94,-37,-169.5,,,
555,-1475,-6,-1693,2245.4,-1125,73,-1748,2080.0,350,79,-55,-165.4,,,
556,-1462,-8,-1682,2228.6,-1122,81,-1738,2070.3,340,89,-56,-158.3,,,
557,-1470,-13,-1675,2228.6,-1137,83,-1743,2082.7,333,96,-68,-145.9,,,
558,-1490,0,-1685,2249.3,-1135,76,-1746,2083.9,355,76,-61,-165.4,,,
559,-1482,-23,-1680,2240.4,-1130,71,-1748,2082.7,352,94,-68,-157.7,,,
560,-1475,-3,-1703,2253.0,-1142,81,-1760,2099.6,333,84,-57,-153.4,,,
561,-1472,-1,-1688,2239.7,-1117,93,-1748,2076.5,355,94,-60,-163.2,,,
562,-1477,-23,-1677,2234.8,-1125,81,-1760,2090.4,352,104,-83,-144.4,,,
563,-1472,-16,-1685,2237.5,-1122,83,-1751,2081.3,350,99,-66,-156.2,,,
564,-1467,-11,-1682,2231.9,-1137,83,-1751,2089.4,330,94,-69,-142.5,,,
565,-1480,-13,-1691,2247.2,-1130,81,-1741,2077.1,350,94,-50,-170.1,,,
566,-1465,0,-1682,2230.5,-1125,83,-1733,2067.8,340,83,-51,-162.7,,,
567,-1465,-6,-1693,2238.9,-1132,81,-1733,2071.5,333,87,-40,-167.3,,,
568,-1477,-3,-1703,2254.3,-1137,86,-1741,2081.2,340,89,-38,-173.1,,,
569,-1470,-3,-1667,2222.6,-1130,91,-1746,2081.8,340,94,-79,-140.8,,,
570,-1477,-3,-1682,2238.5,-1145,73,-1748,2090.9,332,76,-66,-147.6,,,
571,-1457,-1,-1698,2237.4,-1127,91,-1733,2069.2,330,92,-35,-168.2,,,
572,-1465,-18,-1685,2232.9,-1132,78,-1731,2069.8,333,96,-46,-163.1,,,
573,-1470,3,-1682,2233.8,-1115,93,-1751,2077.9,355,90,-69,-155.9,,,
574,-1472,-23,-1677,2231.5,-1135,81,-1746,2084.1,337,104,-69,-147.5,,,
575,-1455,-18,-1680,2222.6,-1140,68,-1751,2090.5,315,86,-71,-132.0,,,
576,-1467,0,-1670,2222.8,-1117,86,-1733,2063.6,350,86,-63,-159.3,,,
577,-1460,-11,-1686,2230.3,-1135,86,-1733,2073.4,325,97,-47,-156.9,,,
578,-1465,-13,-1688,2235.1,-1135,83,-1738,2077.4,330,96,-50,-157.7,,,
579,-1467,-8,-1677,2228.1,-1117,83,-1736,2066.0,350,91,-59,-162.1,,,
580,-1472,-11,-1688,2239.7,-1135,86,-1733,2073.4,337,97,-45,-166.3,,,
581,-1470,-3,-1675,2228.6,-1140,73,-1736,2078.1,330,76,-61,-150.4,,,
582,-1475,-18,-1682,2237.2,-1127,88,-1741,2075.8,348,106,-59,-161.4,,,
583,-1472,-11,-1680,2233.7,-1130,81,-1738,2074.6,342,92,-58,-159.0,,,
584,-1475,-18,-1703,2253.0,-1137,78,-1748,2086.7,338,96,-45,-166.3,,,
585,-1475,-8,-1691,2243.9,-1127,81,-1736,2071.3,348,89,-45,-172.6,,,
586,-1470,-21,-1688,2238.5,-1130,93,-1748,2083.5,340,114,-60,-154.9,,,
587,-1475,0,-1680,2235.6,-1130,73,-1728,2066.0,345,73,-48,-169.7,,,
588,-1470,-1,-1691,2240.6,-1137,83,-1733,2074.4,333,84,-42,-166.3,,,
589,-1475,-3,-1670,2228.1,-1137,86,-1738,2078.7,338,89,-68,-149.5,,,
590,-1465,-16,-1691,2237.4,-1142,78,-1736,2079.4,323,94,-45,-158.0,,,
591,-1467,-3,-1685,2234.1,-1127,83,-1738,2073.1,340,86,-53,-161.0,,,
592,-1480,-21,-1677,2236.8,-1135,83,-1746,2084.1,345,104,-69,-152.6,,,
593,-1477,-3,-1680,2236.9,-1132,83,-1746,2082.5,345,86,-66,-154.4,,,
594,-1472,-3,-1677,2231.4,-1115,93,-1721,2052.7,357,96,-44,-178.7,,,
595,-1477,-6,-1675,2233.2,-1130,76,-1738,2074.4,347,82,-63,-158.8,,,
596,-1467,-6,-1686,2234.9,-1142,76,-1751,2091.9,325,82,-65,-143.0,,,
597,-1477,0,-1691,2245.2,-1120,83,-1746,2076.0,357,83,-55,-169.2,,,
598,-1482,-11,-1693,2250.0,-1142,86,-1751,2092.3,340,97,-58,-157.8,,,
599,-1480,-13,-1696,2251.0,-1140,81,-1746,2086.8,340,94,-50,-164.2,,,
600,-1475,0,-1693,2245.4,-1140,71,-1752,2091.4,335,71,-59,-154.0,,,
601,-1487,-11,-1682,2245.1,-1140,73,-1748,2088.2,347,84,-66,-156.9,,,
602,-1470,-8,-1703,2249.7,-1135,91,-1743,2082.0,335,99,-40,-167.7,,,
603,-1480,-13,-1693,2248.7,-1142,68,-1755,2094.9,338,81,-62,-153.8,,,
604,-1480,-6,-1691,2247.2,-1135,86,-1736,2075.9,345,92,-45,-171.3,,,
605,-1470,-16,-1680,2232.4,-1132,81,-1741,2078.2,338,97,-61,-154.2,,,
606,-1472,-11,-1686,2238.2,-1140,81,-1741,2082.6,332,92,-55,-155.6,,,
607,-1485,-16,-1680,2242.3,-1132,81,-1748,2084.1,353,97,-68,-158.2,,,
608,-1462,-11,-1675,2223.3,-1132,88,-1733,2071.8,330,99,-58,-151.5,,,
609,-1462,0,-1680,2227.1,-1125,78,-1741,2074.3,337,78,-61,-152.8,,,